IgXXX
XXXXX
XXXXX
XXYXX
XXXGX
yXOXX

11111
11111
11111
11111
11111
11111