IXXOXX
XXXXXX
X0GbXX
X00XXX
XXXBgX

111111
111111
101111
100111
111111