XXXXO
XXIrX
BRXXg
XXGXX
XbXXX

11111
11111
11111
11111
11111