XBXOXXy
XXXXGXX
XgXXXYX
bXXXXXI
XRXXXXX
0XXXXrX

1111111
1111111
1121111
1111111
1111111
0111110