GXgrXX
XXXXXX
bI0XXR
XX0YXX
XBXXXO
0XyXXX

111111
111211
110111
110111
111111
011111