Xb00rX
XXX0XX
XXXYXX
BXIXRX
XXXXXX
XXyXOX
gXXGXX

110011
111011
111111
111111
112211
111111
111111