yXXXXX
XXXYXg
XRBXXX
XXXGXX
XrXXXr
XXXRXX
IXXbXO

111111
111111
111111
111111
112111
111111
111111