YXXR0
X0yXX
XXIBX
XXXXX
bXXrX
RXXOX
X0XrX
gXGX0

11110
10121
11111
11111
11111
11111
10111
11110