X⊤0XR
XXrXX
YXXOX
XXIGX
XyXXX
XX0Xg

11011
11111
1⊤111
1⊤111
11111
11011