XYXIXX
XXyXBX
gXX⊤XX
rXXGXX
XOXRXX
XXXXbX

111111
111111
112111
112111
111111
⊤11111
