XXgXXX
XIXbXX
GYXXXX
XX⊤XBR
rXyXOX
XXXXXX

111111
112111
112111
111111
111⊤11
111111