XXXBXR
X0XXXX
gXybIX
X0⊤XYX
X00XOX
⊥XGrXX

1⊥1111
10⊤211
101111
101211
100111
111111