GXI⊤XYX
XXXXRXX
XXgXXXX
XXXXXXX
XXXXXOy
XrXXXXX
0X⊥rXRX

1111111
1111111
1111111
111⊤⊥11
1111111
1111111
0111111