BXXXY
XXX0X
XXyOX
X⊤GgX
XbXXX
RXgGX
XIX0r
XXXXX

11111
11101
11111
11111
11⊤11
11111
11101
11111