XOrXXX
gXXFIX
XXYyXX
GFRXXX
XXXXXX
XXXXX0

111111
112111
111111
111111
111111
111110