0XXXXX
XyXOXX
XFXXXX
XXIXBX
XXGX⊤X
0gXbXY

0⊤⊤⊤11
111111
111111
111111
111111
011111