IXXXXX
XFXGXY
FXyXbX
XrXXXB
XOXRgX
XXXFXX

111111
112111
111111
111111
111111
111111