GXYXXX
XXXXFX
XgXrFX
XXXFXy
XIRXBX
XbXXXO

111111
111111
111111
112111
111111
112111
