0gXXXX
XXFRXX
YXGOXX
XyXXrX
XXyRXX
XXIXrX
YXXXX0

011111
111111
111111
111111
121111
111111
111110