gXYXyR
XXXBXX
IXXXFX
rXGFrX
XORXFX
XXXXbX

111111
111111
112111
111111
111111
112111