XXgXTX
GXbXXX
TROXBX
XXXXyX
XXrXIX
YXXXXX

111111
111111
111111
121211
111111
111111
