XB00XX
XXXXXX
XXGTYy
XrXIXX
bXRTXX
XXOXXg

110011
111111
111111
111111
111111
111111