XXYXXX
XXXXXy
GXTOXR
TIXgbX
XBXXXX
rXXXXX

111111
121111
111111
111111
111111
111111