XXyXXX
BXXbXX
XXXTXX
bXXGXX
XBXIYX
OTXXXG
XgXgXX

111111
112111
111111
111111
111111
111111
111111