RXXXXy
XXTXXX
XyXrYX
Xg00TO
XXBXXX
XXXIXY
GXXXbX

111111
111111
111111
110011
111121
111111
111111