XXXXGX
X0XBTX
XgXXIX
TXORXF
XXrXFr
XXXX0X
XXbRXX

111111
101111
111111
111111
111111
112101
111111
