RXXGgXY
XXXXXXX
XXrOXXb
XXXyyXX
XXXXXBX
TrXYXIX
XXXRXTX

1111111
1111111
1111111
1111111
1211111
1111111
1111111
