RXXyXX
XFXXXX
XXbrXY
XgXOXG
XXXXXX
XFIXBX
GXXgXX

111121
111111
111121
112111
111111
111111
111111
