0BXXX0
XXXXXX
XXbXrb
XOXXXX
XXXXXX
XXXBXb
RXRIXX
XrXBX0

011110
111111
111111
111211
111111
111121
111111
111110
