XXXYXXX
yXXrXXg
XXBXGXX
O0RXI0X
XrX⊤XbX
XXXgXXX
RXXXXXG

1111111
1111111
1112111
101210⊤
1111211
1111111
1111111