XXXXXgX
rXgXRXX
XXXXXYX
XOy⊤XXG
XGXIXRX
XbXXXXX
XXXBrXX

1111111
1111111
⊤211111
⊤111111
⊤111111
1111111
1111111