bXXXgU
XXGXXy
XBXRXX
XTITXO
XyXgXX
XXYXrY
GXXXXU

111111
111111
111111
111111
111111
111111
111111