0XbYXXX
XXXXrXy
XBXXXBX
XGXIFYX
XXRXXXX
XXXyXXb
gXXXOX0

0111111
1111111
1111111
1111111
1111121
1111121
1111110