XXXXbXY
XXXRXXX
XXGXBXX
XXXIGXy
XrgXXBX
XXO⊥gXX
0bXXXX0

⊥111111
1111111
1111111
1221111
1111111
1111121
0111110
