XXXTXXy
XXXRXXX
bXUIYXX
rXRXGXX
XXXXXXg
OUyrXTX
XXXBXGX
YXXgXX0

1111111
1121111
1111111
1111111
1111111
1111111
1111111
1111110