XXIgXXr
XGXXXXX
YXXXRXX
XXXyXBX
XbXXXgX
GXXTrXX
bXXXXXX
UOUBTXR

1111111
1111111
1111111
1111111
1111111
1111121
1111121
1111111