XXXbXXX
BXXXXYG
XXXyXXX
BTIXUXX
XgXbXgX
XXXTrXX
RUXGXXX
XXXrOXR

1111111
1111111
1111112
1111111
1111111
1111111
1111111
1111111