bXXXrXX
XXXBXXR
XXYTXIX
yFXYgFX
XFXXXFX
XXXBXGX
XbXXOXy
RXXrXTX

1111111
1111111
1111111
1111111
1111111
1111111
1111111
1111111