XXXBXXXg
XGXXTXXX
XXXgRXBX
bXXXUGXX
XXrXXYIX
OXXXXXXX
XXyTrUXb
RXXXXXXX

11111111
11111111
11111111
11111111
11111111
11111111
11111111
11111111