0XGTXXR0
XXT0rXXX
gXy0BXYI
OYX0XXXX
RXX0UXgy
XXr0XXXX
0XbUGXX0

01111110
11101111
11101111
11102111
11201211
11101111
01111110