rXgXXIXY
XXXXXXXX
XXXXGXbX
XBRBFXXX
XXXXFXyX
XXYXXXXG
XXXgXyXX
bXOXXXXX

11111111
11111111
11111111
11111111
11111111
11111111
11111111
11111111