YXXXXGX0
XXgXXXXX
XyXXXXXg
XXbXYXIX
yXXOXGXX
XXXXXXrX
BXBXRXXX
0bXrXXRX

11111110
11111111
11111111
11111111
11211111
21111111
11111121
01111110