XXXXGOX0
g0XXXbXX
XXX0XyXB
XGgXXXXX
TYXyXbXY
XXXRRX0X
rUXUXXXX
⊤XITX0XB
0X⊥XXrX0

1⊤111110
10111111
11101111
11111111
1111⊥111
11111101
11111111
11111011
01111110