0XXXXXBX0
OXXbXXXXY
XXXXyXXXX
XXrXFbXyX
BXXFGXXXX
XGFRXXXXX
rXXXXXXYX
XXXgXXXXX
XRXXXgXI0

011111110
111111111
111111111
111211111
111111111
111111111
111211112
111111111
111111110