yXIgXXXB
XXXXXXXX
XYXRXXGX
RXXXGXXX
XgXXXrXX
XXrXXXbX
yXXXXYXO
XXFXXFXb
XXBXXXXX

11111111
11111111
11111111
11111111
11111111
11111111
11111111
11111111
11111111
