0BXbXXY0
gXOXyXXX
XXGXXXXr
IXXYXXXB
RXXXRXXX
XXXGXXbX
XXyFFFXX
0XrXXgX0

01111110
11111111
11111111
11111111
11111111
11111111
12111111
01111110
