XXXRXBXXX
rXXXXXYXX
Ob0T0X0XX
XXXYXXXXy
TUgXrXXXI
bXXXXXXyX
XX0X0X0RX
XGUXgXXXX
XXXBXXXXG

111111111
111211111
110101011
111111111
111111111
111112111
110101011
111111111
111111111