000gXXXX
000XXXOX
XXXRXGXX
rTBXXbXg
rXXXYXyX
XXIyXUXX
XXXTBXXX
YUXXXGXX
000RXXXb

00011111
00011111
11111111
11111111
11111111
11111111
11111111
11121111
00011111