RXXXgXXI
XXXXXXBX
TXXXXYXX
BXGXrXXX
XrXyXXXX
GUXXXXbX
XOXyXRXX
XXXXXXXX
bTXgXUXY

11111111
11111111
11111111
11111111
11111111
11111111
11111111
11111111
11111111