YXBXXIBXX
XXXRXXXFX
XXXXXXGXX
XbXXXXXXX
XgXXXrXXb
XXXXGYXXX
XXyFXXTFg
UrTOXyURX

111111111
111121111
111111111
111111111
111111111
111111111
111112111
111111111