XXXXXXXX
GXXyIXXr
BXXXXXBX
XXXXXRX0
XFFFYXb0
XXgYXGX0
XXRrXXXX
XbXOXXyX
0XXXXgXX

11111111
11111111
11121111
11111110
11111110
11111110
11111121
11111111
01111111
