TXXgXUBX
XXIX⊤XXX
yXXYbXXX
XGXXYXUB
XyXXXXXX
XXXXObXX
TXByXXXg
XXXXXYXX
bXXGXXXX

1111111⊤
11111111
11111211
11111111
11111111
11111111
11112111
11111111
11111111