⊤XXXXXgX
XX⊥bXXXX
XGXXRXXX
bXbFXXXX
IXROXXXB
RXXFXXXr
XXrXXB⊣X
XXXBXXgX
XXXrGXXX

11111111
11111111
11111111
1111⊤111
1111⊣111
1111⊥111
11111111
11111111
11111111