XyXXXXyR
XXXXYXXX
XOXbXrXT
XYXXXBbX
XGXXXXRX
XXXXXXXX
gXXgXIXr
XXTBXXXX
XXXXGXXX

11111111
11111111
11111111
11111111
11111111
11111111
11111111
11111111
11111111
