XXXXXXXXb
XXXrXXXXX
yXXXYXBXX
XXRXXrXXX
FbFXFXFXF
XXXBXOXRI
rXXbXBXXX
XRXXXXXXX
XXXXXBXXb

111111111
111111111
111111111
111111111
111111111
111111111
111111111
111111111
111111111