gXXXXXbXX
XXFyGXFXX
XX⊤XXBXXX
XYXXXrXXB
rXXXXXX⊣X
XXXbRXXXX
XXRgXXXXg
XOXXFX⊥IX
XXXXXGGXX

111111111
111111111
111111111
111111111
1⊥⊤1⊣1111
111111111
111111111
111111111
111111111