gXX00Xr
XTXXXXU
XGXGXGX
XXXgXXT
gRXIXRO
bXXrXXX
XBUBXBX
bXXXXXX
XXX00bX

1110011
1111111
1111111
1121211
1121211
1121211
1111111
1111111
1110011