OXXbXTXR
XYXXXBXX
XXXXXFrX
XbXBXFRr
rXXIXFXX
XBXXXFRX
XXrXXFUX
XXXbXTXy
XRXXUXXX

11111111
11111111
11111111
11111111
11111111
11111111
11111111
11111111
11111111