XXXXYrXXT
XOXXrXXUX
XXRXXXGXX
XyXXVXXXX
GXXXIXXXG
rgXXVXTXX
XXRXXXRXX
XXUXXgXXy
XgXXYXXXX

111211211
111111111
111211111
111111111
111111111
111111111
112111111
111111111
111111111
