XgXXTXXXO
XUXX0rXXX
XyXX0RyXX
VWRX0XgXY
000RIX000
XXGX0XYXr
XrXX0GyUX
XXXX0YXXX
XXXXVXXWT

111111111
111101111
111101111
111101111
000111000
111101121
111101111
111101111
111111111
