train_size = 2
XXXXAXXXAXX
XXXXXXXXXXX
XXXXXXXXXXX
XXXXaXbXaXX
XXBXXXXXXXX
IXXXbXXXBXQ
XXBXXXXXXXX
XXXXaXbXaXX
XXXXXXXXXXX
XXXXXXXXXXX
XXXXAXXXAXX
