train_size = 2
XXXBbXXX
XXXXXXXX
XXXaAXXQ
XXXXXXXX
XXXaAXXX
IXXXXXXX
XXXXXXXX
XXXXXXXX
