train_size = 2
XXXXXXX
XAXXXBX
XXXXXXX
IXXXXXQ
XXXXXXX
XbXXXaX
XXXXXXX
