train_size = 2
XXXXXXXXX
XXXXXXXXI
XXAAAAAXX
XXXXXXXXX
XXXXXXXXX
XXXXXXXXX
XXaaaaaXX
XXXXXXXXQ
XXXXXXXXX
