train_size = 2
XXXXXXXX
XXXAAXXX
XXXXXXXX
IXXXXXXQ
XXXXXXXX
XXXaaXXX
XXXXXXXX
