train_size = 2
XXXbaXXX
QXXXXXXX
XXXABXXX
XXXXXXXQ
XXXabXXX
IXXXXXXX
XXXBAXXX
