train_size = 2
XXXXXXXXXX
XXXXXXXXXX
XXXAaaAXXX
IXXXXXXXXQ
XXXAaaAXXX
XXXXXXXXXX
XXXXXXXXXX
