train_size = 2
XXXXXXXXXXX
XXXXXXXXXXQ
XXBXaXbXXXX
XXXXXXXXAXX
XXAXXaXXXXX
XXXXXXXXAXX
XXBXaXbXXXX
XXXXXXXXXXI
XXXXXXXXXXX
