train_size = 2
XXXXQXXXX
XAbXXXaBX
XXXXXXXXX
IXXXXXXXX
XXXXXXXXX
XBaXXXbAX
XXXXXXXXX
