train_size = 2
XXXXXXXXX
XXBBXXXbX
XXXXXXXbX
IXXXXXXXQ
XXXXXXXaX
XXAAXXXaX
XXXXXXXXX
