# I : Entry
# Q : Exit
# O : Obstacle
# A : Monster purple in
# a : Monster purple out
# B : Monster orange in
# b : Monster orange out
# c : Red out which accept any monster
# D : Monster green in
# d : Monster green out

[Level 01]
train_size = 2
XXXXXXXX
XXXXXXXX
XAXXXXXX
IXXXXXXQ
XXXXXXaX
XXXXXXXX
XXXXXXXX

[Level 02]
train_size = 2
XXXXXXXX
XXAXXXXX
XXXXXXaX
IXXXXXXQ
XXXXXXaX
XXAXXXXX
XXXXXXXX

[Level 03]
train_size = 2
XXXXXXXXX
XBXXaXXBX
XXXXXXXXX
IXXXXXXXQ
XXXXXXXXX
XbXXAXXbX
XXXXXXXXX

[Level 04]
train_size = 2
XXXXXXXX
XXXAAXXX
XXXXXXXX
IXXXXXXQ
XXXXXXXX
XXXaaXXX
XXXXXXXX

[Level 05]
train_size = 2
XXXXQXXXX
XAbXXXaBX
XXXXXXXXX
IXXXXXXXX
XXXXXXXXX
XBaXXXbAX
XXXXXXXXX

[Level 06]
train_size = 2
XXXXXXXXX
XXBBXXXbX
XXXXXXXbX
IXXXXXXXQ
XXXXXXXaX
XXAAXXXaX
XXXXXXXXX

[Level 07]
train_size = 2
XXXXXXX
XAXXXBX
XXXXXXX
IXXXXXQ
XXXXXXX
XbXXXaX
XXXXXXX

[Level 08]
train_size = 2
XXXbaXXX
QXXXXXXX
XXXABXXX
XXXXXXXQ
XXXabXXX
IXXXXXXX
XXXBAXXX

[Level 09]
train_size = 2
XXXXXXXXXXX
XXXXXXXXXXQ
XXBXaXbXXXX
XXXXXXXXAXX
XXAXXaXXXXX
XXXXXXXXAXX
XXBXaXbXXXX
XXXXXXXXXXI
XXXXXXXXXXX

[Level 10]
train_size = 2
XXXXXXXXX
XXXXXXXXI
XXAAAAAXX
XXXXXXXXX
XXXXXXXXX
XXXXXXXXX
XXaaaaaXX
XXXXXXXXQ
XXXXXXXXX

[Level 11]
train_size = 2
XXXXXXXXXX
XXXXXXXXXX
XXXAaaAXXX
IXXXXXXXXQ
XXXAaaAXXX
XXXXXXXXXX
XXXXXXXXXX

[Level 12]
train_size = 2
XXXBbXXX
XXXXXXXX
XXXaAXXQ
XXXXXXXX
XXXaAXXX
IXXXXXXX
XXXXXXXX
XXXXXXXX

[Level 13]
train_size = 2
XXXAXXXAXXX
QXXXXXXXXXX
XXXXXXXXXXX
XXXaXbXaXXX
XBXXXXXXXBX
XXXbXXXbXXX
XBXXXXXXXBX
XXXaXbXaXXX
XXXXXXXXXXX
IXXXXXXXXXX
XXXAXXXAXXX

[Level 14]
train_size = 2
XXXXAXXXAXX
XXXXXXXXXXX
XXXXXXXXXXX
XXXXaXbXaXX
XXBXXXXXXXX
IXXXbXXXBXQ
XXBXXXXXXXX
XXXXaXbXaXX
XXXXXXXXXXX
XXXXXXXXXXX
XXXXAXXXAXX
