train_size = 2
XXXXXXXXX
XBXXaXXBX
XXXXXXXXX
IXXXXXXXQ
XXXXXXXXX
XbXXAXXbX
XXXXXXXXX
