train_size = 2
XXXXXXXX
XXAXXXXX
XXXXXXaX
IXXXXXXQ
XXXXXXaX
XXAXXXXX
XXXXXXXX
