train_size = 2
XXXAXXXAXXX
QXXXXXXXXXX
XXXXXXXXXXX
XXXaXbXaXXX
XBXXXXXXXBX
XXXbXXXbXXX
XBXXXXXXXBX
XXXaXbXaXXX
XXXXXXXXXXX
IXXXXXXXXXX
XXXAXXXAXXX
