train_size = 3
XXIXXXXXXXX
XXXXXXXXXXO
XbXXXXXXXaX
XXXAAXBBXXQ
XbXXXXXXXaX
XXXXXXXXXXO
XXXXXXXXXXX
