train_size = 3
XXXXXXXIXXX
bXXXXXXXXXX
XXABXaXXXXa
XXXXXXXABXQ
XXABXaXXXXb
bXXXXXXXXXX
XXXXXXXXXXX
