train_size = 3
XXXOXQXOXXX
XXXXaXaXXXX
XXXXXXXXXXX
XXXXOXOXXXX
XXXXXXXXXXX
XXXObXbOXXX
XBXXOXOXXAX
XBXXXXXXXAX
XXXXXIXXXXX
