train_size = 3
XXXOXQXOXXX
XXXXaXaXXXX
XXXXXXXXXXX
XXObXXXbOXX
XXXOXXXOXXX
XXXXXXXXXXX
XXXXXXXXXXX
BXXXXXXXXXA
BXXXXIXXXXA
