train_size = 2
XXXXXQXXXXXX
XXXXXaOXAXXX
XXXXXXXXXXXX
XAXOaXXXXXXX
XXXXXXXXXXXI
XXXXXaOXAXXX
XXXXOXXXXXXX
