train_size = 3
XXXXXOQOXXXXX
XXXXXaXaXXXXX
XXXXXXXXXXXXX
XXBbXXAXXbBXX
XXBbXXAXXbBXX
XXXXXXXXXXXXX
XXXXXXXXXXXXX
XXXXXXXXXXXXX
XXXXXXIXXXXXX
