# I : Entry
# Q : Exit
# O : Obstacle
# A : Monster 1 (purple) in
# a : Monster 1 out
# B : Monster 2 (orange) in
# b : Monster 2 out

[Level 01]
train_size = 2
XXXXXQXXXXXX
XXXXXaOXAXXX
XXXXXXXXXXXX
XAXOaXXXXXXX
XXXXXXXXXXXI
XXXXXaOXAXXX
XXXXOXXXXXXX

[Level 02]
train_size = 3
XXXOXQXOXXX
XXXXaXaXXXX
XXXXXXXXXXX
XXObXXXbOXX
XXXOXXXOXXX
XXXXXXXXXXX
XXXXXXXXXXX
BXXXXXXXXXA
BXXXXIXXXXA

[Level 03]
train_size = 3
XXXOXQXOXXX
XXXXaXaXXXX
XXXXXXXXXXX
XXXXOXOXXXX
XXXXXXXXXXX
XXXObXbOXXX
XBXXOXOXXAX
XBXXXXXXXAX
XXXXXIXXXXX
