train_size = 3
XXXXXXXIXXX
XXXXXXXXXXA
XXXOOXXXXXA
XXXXXXXXXbX
XaaBBaaXXXQ
XXXXXXXXXbX
XXXOOXXXXXA
XXXXXXXXXXA
XXXXXXXXXXX
