train_size = 3
XXXIXXXXXX
XXXXXXXXXX
bXXXXXXXXb
XXBBXXBBXQ
bXXXXXXXXb
XXXXXXXXXX
XXXXXXXXXX