train_size = 2
XXXXXXXX
XXXXXXXQ
XXXXBXXX
XbXXXXXX
XdXXDXXX
XbXXXXXX
XXXXBXXX
XXXXXXXI
XXXXXXXX
