train_size = 2
XXXXXdXXXXX
QXXXXXXXXXX
XXXXXXXXXXX
XXBXXXXbXXX
XXaXXXXAXXX
XXBXXXXbXXX
XXXXXXXXXXX
XXXXXXXXXXI
XXXXXDXXXXX
