train_size = 3
XXXXXXXXXXX
XdbXXAXXDXX
XXXXXXXXXXX
QXXXXXXXOXI
XXXXXXXXXXX
XdaXXBXXDXX
XXXXXXXXXXX
