train_size = 2
XXXXXXXXXXXd
XXXXXXXXXXXX
XXbXXXXXXBXX
XXXXXXXXXXXX
IXXXDXDXXXXQ
XXXXXXXXXXXX
XXbXXXXXXBXX
XXXXXXXXXXXX
XXXXXXXXXXXd
