train_size = 2
XXXXXQXXXXX
XXXXXXXXXXX
XXDXXAXXDXX
IXXXXXXXXXX
XXdXXaXXdXX
XXXXXXXXXXX
XXXXXXXXXXX
