train_size = 3
XXIXXXXXXXX
XXXXXXXXXXX
bXXXDDDXXXd
XXXXXXXXXXX
XXXbXXXdXXQ
XXXXXXXXXXX
bXXXBBBXXXd
XXXXXXXXXXX
XXXXXXXXXXX
