train_size = 3
OXIXXXXXXbdO
XXXXXBDXXXXX
bXXXXXXXXXXX
XXXXXBDXXXXQ
dXXXXXXXXXXX
XXXXXBDXXXXX
OXXXXXXXXbdO
