train_size = 3
XXXXXXXXXXXX
XXXXXXXXXXXI
XXXXXXXBBXXX
XbXbXXXXXXDX
XdXdXXXXXXXX
XbXbXXXXXXDX
XXXXXXXBBXXX
XXXXXXXXXXXQ
XXXXXXXXXXXX
