train_size = 2
XXXXXXX
XBXXXDX
XXXXXXX
QXXXXXI
XXXXXXX
XdXXXbX
XXXXXXX
