train_size = 2
XXXIXXXQXXX
XDXXXXXXXdX
XXXXXXXXXXX
XXXXXXXXXXX
XAXXXbXXXXX
XXXXXXXXXXX
XXXXXBXXXXX
XdXXXXXXXdX
XXXXXXXXXXX
