# I : Entry
# Q : Exit
# O : Obstacle
# A : Monster purple in
# a : Monster purple out
# B : Monster orange in
# b : Monster orange out
# c : Red out which accept any monster
# D : Monster green in
# d : Monster green out

[Level 01]
train_size = 2
XXXXXQXXXXX
XXXXXXXXXXX
XXDXXAXXDXX
IXXXXXXXXXX
XXdXXaXXdXX
XXXXXXXXXXX
XXXXXXXXXXX

[Level 02]
train_size = 2
XXXXXdXXXXX
QXXXXXXXXXX
XXXXXXXXXXX
XXBXXXXbXXX
XXaXXXXAXXX
XXBXXXXbXXX
XXXXXXXXXXX
XXXXXXXXXXI
XXXXXDXXXXX

[Level 03]
train_size = 2
XXXXXXXX
XXXXXXXQ
XXXXBXXX
XbXXXXXX
XdXXDXXX
XbXXXXXX
XXXXBXXX
XXXXXXXI
XXXXXXXX

[Level 04]
train_size = 2
XXXXXXX
XBXXXDX
XXXXXXX
QXXXXXI
XXXXXXX
XdXXXbX
XXXXXXX

[Level 05]
train_size = 3
XXXXXXXXXXX
XdbXXAXXDXX
XXXXXXXXXXX
QXXXXXXXOXI
XXXXXXXXXXX
XdaXXBXXDXX
XXXXXXXXXXX

[Level 06]
train_size = 3
XXXXXXXXX
dXXXXXXXX
dXXDBDXXb
XXXXXXXXX
QXXXXXXXQ
XXXXXXXXX
dXXDBDXXb
dXXXXXXXX
XXXXIXXXX

[Level 07]
train_size = 2
XXXXXXXX
XbXXXdXX
XXXXXXXI
XDXXXBXX
XXXXXXXX
XXXXXXXX
XDXXXBXX
XXXXXXXQ
XbXXXdXX
XXXXXXXX

[Level 09]
train_size = 3
XXXXXXXXXX
XBXXbbXXBX
XBXXbbXXBX
XXXXXXXXXX
QXXXOXXXXI
XXXXXXXXXX
XDXXddXXDX
XDXXddXXDX
XXXXXXXXXX

[Level 09]
train_size = 3
dXXXXXb
XXXXXXX
XXXXXXX
XXBXDXX
IXXXXXQ
XXBXDXX
XXXXXXX
XXXXXXX
dXXXXXb

[Level 10]
train_size = 3
XXXXXXXXXX
XXXbdXXXXX
XXXXXXXXXI
XXOOOOXXXX
XXXXXXXXXX
XXDBDBXXXX
XXXXXXXXXX
XXOOOOXXXX
XXXXXXXXXQ
XXXbdXXXXX
XXXXXXXXXX

[Level 11]
train_size = 2
XXXIXXXQXXX
XDXXXXXXXdX
XXXXXXXXXXX
XXXXXXXXXXX
XAXXXbXXXXX
XXXXXXXXXXX
XXXXXBXXXXX
XdXXXXXXXdX
XXXXXXXXXXX

[Level 12]
train_size = 3
XXXXXXXXXXXX
XXXXXXXXXXXI
XXXXXXXBBXXX
XbXbXXXXXXDX
XdXdXXXXXXXX
XbXbXXXXXXDX
XXXXXXXBBXXX
XXXXXXXXXXXQ
XXXXXXXXXXXX

[Level 13]
train_size = 2
XXXXXXXXXXXd
XXXXXXXXXXXX
XXbXXXXXXBXX
XXXXXXXXXXXX
IXXXDXDXXXXQ
XXXXXXXXXXXX
XXbXXXXXXBXX
XXXXXXXXXXXX
XXXXXXXXXXXd

[Level 14]
train_size = 3
OXIXXXXXXbdO
XXXXXBDXXXXX
bXXXXXXXXXXX
XXXXXBDXXXXQ
dXXXXXXXXXXX
XXXXXBDXXXXX
OXXXXXXXXbdO

[Level 15]
train_size = 3
XXIXXXXXXXX
XXXXXXXXXXX
bXXXDDDXXXd
XXXXXXXXXXX
XXXbXXXdXXQ
XXXXXXXXXXX
bXXXBBBXXXd
XXXXXXXXXXX
XXXXXXXXXXX
