train_size = 3
XXXXXXXXXX
XBXXbbXXBX
XBXXbbXXBX
XXXXXXXXXX
QXXXOXXXXI
XXXXXXXXXX
XDXXddXXDX
XDXXddXXDX
XXXXXXXXXX
