train_size = 3
XXXXXXXXXX
XXXbdXXXXX
XXXXXXXXXI
XXOOOOXXXX
XXXXXXXXXX
XXDBDBXXXX
XXXXXXXXXX
XXOOOOXXXX
XXXXXXXXXQ
XXXbdXXXXX
XXXXXXXXXX

