train_size = 2
XXXXXXXX
XbXXXdXX
XXXXXXXI
XDXXXBXX
XXXXXXXX
XXXXXXXX
XDXXXBXX
XXXXXXXQ
XbXXXdXX
XXXXXXXX
