train_size = 3
XXXXXXXXX
dXXXXXXXX
dXXDBDXXb
XXXXXXXXX
QXXXXXXXQ
XXXXXXXXX
dXXDBDXXb
dXXXXXXXX
XXXXIXXXX
