train_size = 3
XQXXXXXXXX
XXXaXXaXXX
XXXXXXXXXI
XXXBXXBXXX
XXXcXXcXXX
XOXAXXAXOX
XXXcXXcXXX
XXXBXXBXXX
XXXXXXXXXX
