train_size = 3
XXXXXXXX
XacXXBBX
XXXXXXXX
XXXOXXXX
IXXXXXXQ
XXXXOXXX
XXXXXXXX
XbcXXAAX
XXXXXXXX
