train_size = 3
XXXXXXXIXA
XXbXXcXXXA
QXXXXXXXXX
XXaXXcXXXB
XXXXXXXXXB
