train_size = 2
BXQXXXXXXIXA
XXXXcXXaXXXX
XXXXXXXXXXXX
XXXXXXXXXXXQ
XXXXbXXcXXXX
AXXXXXXXXXXB
