train_size = 3
XXXXXXXXXXX
XXXAXXXAXXX
bXXAXXXAXXb
cXXXXXXXXXc
aXXXXBXXXXa
XXXXXBXXXXX
XXXXXXXXXXQ
XXIXXXXXXXX
