train_size = 2
XXXXXXXXX
XXXXXXXXI
XXcXXXBXX
XXaXOXAXX
XXcXXXBXX
XXXXXXXXX
XQXXXXXXX
