train_size = 2
XbXXQXXbX
XXXXXXXXX
XAXOBOXAX
XXXXXXXXX
XXXXBXXXX
XcXXXXXcX
XXXXIXXXX
