train_size = 2
XXXXXXXXXX
XXXXXXXXXX
XBBXcXcXaX
XXXXXXXXXX
IXXXAXAXXQ
XXXXXXXXXX
XBBXcXcXaX
XXXXXXXXXX
XXXXXXXXXX
