train_size = 3
XXBBABBXX
XXXXXXXXI
XXXXXXXXX
XXOXXXOXX
XXcXXXcXX
XXXXaXXXX
XXcXXXcXX
XXXXQXXXX
