train_size = 4
XXXXXXXXXIXXXXX
XXXXXXXXXXXXXXQ
XXXXXXXXXXXXXXX
XXBBXXAAXXXcbXX
XXXXXXXXXXXbcXO
XXXXXXXXXXXcbXX
XXAAXXBBXXXbcXX
XXXXXXXXXXXXXXX
XXXXXXXXXXXXXXX
XXXXXXXXXXXXXXX
