train_size = 3
XXXOXQXOXXX
XXXXbXbXXXX
XXAXXXXXaXX
IXXXOXOXXXQ
XXAXXXXXaXX
XXXXBXBXXXX
XXXXXXXXXXX
