train_size = 3
XXXXXXXXXXXXX
IXXXXXXXXXXXX
XXXXXXXBBBXXX
XAXXaXXXXXXXX
XAOXaXXXOXXXX
XAXXaXXXXXXXX
XXXXXXXbbbXXX
XXXXXXXXXXXXQ
XXXXXXXXXXXXX
