train_size = 3
AXXXXXXXX
XXAXXaXXX
XXXXOaOXX
IXXXXXXXQ
XXXXObOXX
XXBXXbXXX
BXXXXXXXX
