train_size = 3
XXXXXXXXX
XXXABAXXX
XXXXXXXXX
IXXXXXXXQ
XXXaXaXXX
XXXXbXXXX
XXXXXXXXX
