train_size = 3
XXIXXXXX
XXXXXaaX
XBXXXXXX
XAXAXXXQ
XBXXXXXX
XXXXXbbX
XXXXXXXX
