train_size = 3
XXXXXXXXQX
IXXXXXXXXX
XXXXXXXXXX
XXBXaaXBXX
XXAXbbXAXX
XXXXXXXXXX
XXXXXXXXXX
