train_size = 3
XXIXXXXXa
XXXXXXXXa
XXXXXXXXX
XXABBAXXQ
XXXXXXXXX
XXXXXXXXb
XXXXXXXXb
