train_size = 3
XAXXaXBXXXb
IXXXXXXXXXX
XAXXaXBXXXX
XXXOOOOXXXX
XXXaXAXXXXX
XXXXXXXXXXX
XQXaXAXXXXb
