train_size = 3
XXXXXXOXX
IXXXXXXXX
XXBBXAAXX
XXXXXXXOX
XOXXXXXXX
XXbbXaaXX
XXXXXXXXQ
XXXXXXXXX

