train_size = 3
bXXXXXXXa
XXXXXBBXX
XXAbXXXXX
IXXXXXXXQ
XXAbXXXXX
XXXXXBBXX
bXXXXXXXa
