train_size = 3
XXXXXQXXXX
AXXXXXXXXX
AXXaXXXaXX
AXXXXaXXXI
AXXaXXXaXX
AXXXXXXXXX
XXXXXXXXXX
