train_size = 3
XXXXXIXXXXXX
XXXXXXXXXXXX
XXAXXXXXXaXX
XXAOXXXXXaXX
XXAXXXXXOaXX
XXAXXXXXXaXX
QXXXXXXXXXXX
XXXXXXXXXXXX

