train_size = 3
XQXXXXXIX
XXXXXXXXX
XXaOXOaXX
XXOXXXOXX
XXXXXXXXX
aXOXXXXXO
aXAOXAXAX
XXAXXXXXX
XXXXXXXXX
