train_size = 3
XIXXXXXXXX
XXXXXXXXXX
XXAXXXXXaX
XXAXXXOXaX
QXAXXXXXaX
XXAXOXXXaX
XXAXXXXXaX
XXXXXXXXXX
XXXXXXXXXX
