train_size = 3
XXXXXXXXXXX
XXXXXXXXXXI
XXXXXXXXXXX
XXAOXXXXXaX
XXAXXXXXXaX
QXAXXXXXXaX
XXAXXXXXXaX
XXAXXXXXXaX
XXAXXXXXXaX
XXXXXXXXXXX
