train_size = 3
XXXXXXa
XXXXXXX
XAAXXXX
XXOXXaX
QXXXXXI
XXXXXaX
XAAXXXX
XXXXXXX
XXXXXXa
