train_size = 3
XXXXXXXXXX
XXXXXXXXXI
XXAXOXXXXX
XXAXXXOXXX
XXXXXXXXXX
XXAXXOaaXX
XXAXXXaaXX
XXXXXXXOXX
XQXXXXXXXX
