train_size = 3
XXXXXXXQXXXXXX
XXaXXXXXXXXaXX
XXaXXOOOOXXaXX
XXXXXAAAAXXXXX
XXXXXXXXXXXXXX
XXXXXXXXXXXXXX
XXXXXAAAAXXXXX
XXaXXOOOOXXaXX
XXaXXXXXXXXaXX
XXXXXXIXXXXXXX
